0,0,0,0,0,0,0,0,0,0,0,0,
0,0,0,0,1,1,1,0,0,0,0,0,
0,0,0,0,1,0,1,0,0,0,0,0,
2,1,1,1,1,0,1,1,1,1,0,0,
0,0,0,0,0,0,0,0,0,1,0,0,
0,0,0,0,0,0,0,0,0,1,0,0,
0,0,0,0,0,0,1,1,1,1,0,0,
0,0,0,0,0,0,1,0,0,0,0,0,
0,0,0,0,0,0,1,0,0,0,0,0,
0,0,0,0,0,0,3,0,0,0,0,0,
0,0,0,0,0,0,0,0,0,0,0,0,
0,0,0,0,0,0,0,0,0,0,0,0,
3,0,3,1,
3,1,3,2,
3,2,3,3,
3,3,3,4,
3,4,2,4,
2,4,1,4,
1,4,1,5,
1,5,1,6,
1,6,2,6,
2,6,3,6,
3,6,3,7,
3,7,3,8,
3,8,3,9,
3,9,4,9,
4,9,5,9,
5,9,6,9,
6,9,6,8,
6,8,6,7,
6,7,6,6,
6,6,7,6,
7,6,8,6,
8,6,9,6,