0,0,0,0,0,0,0,0,0,0,0,0,
0,0,0,0,0,0,0,0,0,0,0,0,
2,1,1,1,1,1,0,0,0,0,0,0,
0,0,0,0,0,1,0,0,0,0,0,0,
0,0,0,0,0,1,0,0,0,0,0,0,
0,0,0,0,0,1,0,0,0,0,0,0,
0,0,0,0,0,1,0,0,0,0,0,0,
0,0,0,0,0,1,0,0,0,0,0,0,
0,0,0,0,0,1,0,0,0,0,0,0,
0,0,0,0,0,1,1,1,1,1,1,3,
0,0,0,0,0,0,0,0,0,0,0,0,
0,0,0,0,0,0,0,0,0,0,0,0,
2,0,2,1,
2,1,2,2,
2,2,2,3,
2,3,2,4,
2,4,2,5,
2,5,3,5,
3,5,4,5,
4,5,5,5,
5,5,6,5,
6,5,7,5,
7,5,8,5,
8,5,9,5,
9,5,9,6,
9,6,9,7,
9,7,9,8,
9,8,9,9,
9,9,9,10,
9,10,9,11,